G    G    G    G    G    G    G    G    G    G    G    G    G    G    G    G    G    G    G    G    W    W    W    G    W    W    W    W    W    W    G    G    G    G    G    G    G    G    G    G    G    G    G    G    G    G    GX   G    G    W    W    W    W    W    W    W    W    W    G    G    W    G    G+   W    W    W    G    G    G    G    
G S  M    M    G    G    G    G    G    G    G    G    G    G    G    G    G    G    G    G    G    G    G    G    G    G    G    G    W    W    W    G    G    G    G    G    G    G    G    G    G    G    G    G    G    G    GX   G    GX   G    GX   W    W    W    W    W    W    G    G    G    G    G    G    W    W    W    G B  G    G    G    G    
GX D M    M    G    G    G    G    G    G    G    G    G    G    G    G    G    G    G    M    G    G    G    G    G    G    G    W    W    W    G    G    G    G    G    G    G    G    G    G    G    G    G    G    G    G    GX   GX   G    G    G    G    G    W    W    W    G    G    G    G    G    G    W    W    W    W    W    W    G    G    G    
G    G L  G    G    G    W    W    W    G    G    G    G    G    G    G    G    G    G    G    G    G    G    G    G    G    W    W    W    G    G    G    G    G    G    G    G    G    G    G    G    G    G    G    G    M    M    G    GX   GX   G    GX   G    G    G    G    G    G    G    G    G    G    G    W    W    W    G    G    G    G    G    
G B  G B  G    G    G    W    W    W    W    G    G    G    G    M    G    G    G    G    G    G    M    G    G    G    G    G    W    W    W    G    G    G    G    G    G    G    G    G    G    G    G    G    G    G    M    M    GX   G    G    G    G    W    W    W    G    G    G    G    G    G    G*   G    G    W    W    W    G    G    G    G    
G    G S  G    G    G    G    W    W    W    G*   G    G    M    M    G    G    G    G    G    G    G    G    G    G    G    G    W    W    W    G    G    G    G    G    G    G    G    G    G    G    G    G    G    M    M    M    M    G    G    G    G    G    W    W    W    G    G    G    W    W    W    G    G    G    G    G    G    G    G    G    
G    G    G    G    G    G    G    G    G    G    G    G    G    G    G    G    G    G    G    G    G    G    G    G    G    W    W    W    G    G    G    G    G    G    G    G    G    G    G    G    G    G    G    G    M    M    M    M    G    G    G    G    G    G    W    W    W    G    G    W    W    W    G    G    G    G    G    G    G    G    
G    G    G    G    G    G    G    G    G    G    G    G    G    G    G    G    G    G    G    G    G    G    G    G    G    W    W    W    G    G    G    G    G    G    G    G    G    G    G    G    G    G    G    G    G    M    M    G    G    G    G    G    G    G    G    G    G    G    G    G    G    G    G    G    G    G    G    G    G    G    
G    G    G    G    G    G    G    G    G    G B  G    G    G    G    G    G    W    G    G    G    G    G    G    G    W    W    W    G B  G    G    G    G    G    G    G    G    G    G    G    G    G    G    G    G    M    M    G    G    G    G    G    G    G    G    G    G    G    G    G    G    G    G    G    G    G    G    G    G    G    G    
G    G    G    G    G    G    G    G    G    G B  G    G    G    G    G    G    G    G    G    G    G    G    G    G    G    W    W    W    G    G    G    G    G    G    G    G    G    G    G    G    G    G    G    G    M    M    G    G    G    G    G    G    G    G    G    G    G    G    G    G    G    G    G    M    G    G    G    G    G    G    
G    G    G    G    M    G    G    G    G B  G B  W    W    G    G    G*   G    G    G    G    G    G    G    G    G    G    G    W    W    W    G    G    G    G    G    G    G    G    G    G    G    G    G    G    M    M    M    M    G    G    G    G    G    M    G    G    G    G    G    G    G    G    M    M    M    M    G    G    G    G    G    
G    G    G    M    M    G    G    G    G    G    W    W    W    G    G    G    G    G    M    G    G    G    G    G    G    G    G    W    W    W    G    G    G    G    G    G    G    G    G    G    G    G    M    M    G    M    G    G    G    G    G    M    M    G    G    G    G    G    G    G    M    M    M    M    G    G    G    G    G    G    
G    G    G    M    G    G    G    G    G    G    G    G    G    G    G    G    G    G    M    G    G    G    G    G    G    G    G    G    W    W    W    G    G    G    G    G    G    G    G    G    G    M    M    G    G    G    G    G    G    G    G    G    G    G    G    G    G    G    G    M    M    M    M    G    G    G    G    G    G    G    
G    G    G    G    G    G    G    G    G    G    G    G    G    G    G    G    G    G    G    G    G    W    G    G    G    G    G    W    W    W    G    G    G    G    G    G    G    G    G    G    G    M    M    M    M    G    G    W    W    W    G    G    G    G    M    G    G    G    M    M    M    M    G+   G    G    G    G    G    G    G    
G    G    G    G    G    G    G    G    G    M    G    G    G    G    G    G    G    G    G    G    W    W    W    G    G    G    W    W    W    G+   G    G    G    G    G    G    G    G    G    M    M    M    M    M    M    M    G    G    W    W    W    G    M    M    M    G    G    M    M    M    M    M    M    M    M    G    G    G    G    G    
W    W    W    G    G    G    G    G    G    G    G    G    G    G    G    G    G    G    G    W    W    W    W    G    G    G    G    W    W    W    G    G    G    G    M    G    G    G    G    G    M    M    M    M    M    G    G    G    G    G    G    G    G    M    M    G    M    M    M    M    M    M    M    M    G    G    G    G    G    G    
G    G    G    G    G    G    G    G    G    G    G    G    G    G    G    W    W    G    G    G    W    W    W    G    G    G    G    G    W    W    W    G    G    M    M    M    M    M    M    M    M    M    M    G    G    G    G    G    G    G    G    G    G    G    G    G    M    M    M    M    M    M    M    M    G    G    G    G    G    G    
G C  G    G    G+   G    G    G    M    G    G    G    G    G    G    G    G    G    G    G    G    G    W    W    W    G    G    G    W    W    W    G    G    G    G    G    M    M    M    M    M    G L  G    G    G    G    G    G    G    M    M    G    G    G    G    G    G    G    G    G    G    G    M    M    M    M    G    G    G    G    G    
G    G    G    G    G    G    G    G    G    G    G    G    G    G    G    G    G    G    G    G    G    G    G    G    G    G    W    W    W    G    G    G    G    G    G    G    M    M    M    M    M    G    G    G    G    G    G    M    M    G    G    G    G    G    G    G    G    G    G    G    M    M    M    M    G    G    G    G    G    G    
G    G    M    M    G    G    G    G    G    G    G    G    G    W    W    G    G    G    G    G    G    G    G    G    G    W    W    W    G    G    G    G    G    G    G    G    G    M    M    M    G S  G    G    G    G    G    M    M    G L  G    G    G    G B  G    G    G    G    G    G    G    G    G    G    G    G    G    G    G    G    G    
G    G    G    G    G    G    G    G    G    G    G    G    G    G    G    G    G    G    G    G    G    G    G    G    G    G    G    G    G    G    G    G    G    G    G    G    G    G    G    M    M    G    G    G    G    G    G    M    M    G    G    G    G    G    G    G    G    G    G    G    G    G    G    G    G    G    G    G    G    G    
G    G    G    G    G    G    G    G    G    G    G    G    G    G    G    G    G    G    G    G    G    G    G    G    G    G    G    G    G    G    G    G    G    G    G    G    G    G    G    G    M    M    G    G    G    G    G    G    G    G    G    G    G    G    G    G    G    G    G    G    G    G    G    G    G    G    G    G    G    G    
G    G    G    G    G    G    G    G    G    G    G    G    G    G    G    M    M    M    M    G    G    G    G    G    G    G    G    G    G    G    G    G    G    G    G    G    G    G    G    G    G    M    M    G    G    G    G    G    G    G    G    G    G    G    G    G    G    G    G    G    G    G    G    G    G    G    G    G    G    G    
G    G+   G    G    G    G    G    G    G    G    G    G    G    G    G    G    G    M    M    M    M    G    G    G    G    G    G    G    G    G    G    G    G    G    G    G    G    G    G    G    G    M    M    M    G    G    G    G    G    G    G    G    G    G    G    G    G    M    G    G    G    G*   G    G    G    G    G    G    G    G    
G    G    G    G    G    G    G    G    G    G    G    G    G    G    G    G    M    M    M    M    M    M    M    M    G    G    G    G    G    G    G    G    G    G    G    G    G    G    G    G    G    G    M    M    G    G    G    G    G    G    G    G    G    G    G    M    M    M    M    G    G    G    G    G    G    G    G    G    G B  G    
G    G    G    G    M    G    G    G    G B  G B  W    W    G    G    G*   G    M    M    M    M    G    G    G    M    M    M    M    G    M    M    M    M    G    G    G    M    M    M    M    G    G    M    M    M    M    M    M    G    G    G    G    G    G    G    M    M    M    M    G+   G    G    G    W    W    W    G    G    G    G    G    
G    G    G    G    G    G    G    G    G    G    G    G    G    G    G    M    M    M    M    G    G    G    G    G    M    M    M    M    M    M    M    M    M    M    M    M    M    M    M    M    G    G    M    M    M    M    M    M    G    G    G    G    G    G    G    G    G    M    G    G    G    W    W    W    W    W    W    G    G    G    
W    W    W    G    G    G    G    G    G    G    G    G    G    M    M    M    M    G    G    G    G    G    G    G    G    G    G    G    G    G    G    M    M    M    M    G    G    G    G    G    G    G    G    M    M    M    M    M    M    G    G    G    G    G    G    G    G    G    G    G    W    W    W    G C  G S  W    W    W    G    G    
M    M    M    M    M    M    M    M    M    M    M    M    M    M    M    M    G    G    G    G    G    G    G    G    G    G    G    G    G    G    G    G    G    G    G    G    G    G    G    G    G    G    M    M    M    M    M    M    M    M    G    G    G    G    G    G    G    G    G    G    W    W    W    G L  W    W    W    G    G    G    
M    M    M    M    M    M    M    M    M    M    M    M    M    G    G    G    G    G    G    G    G    G    G    G    G    G    G    G    G    W    G    G    G    G    G    G    G    G    G    G    G    G    G    G    G    M    M    M    M    M    G    G    G    G    G    G    G    G    G    G    W    W    W    W    W    W    G    G    G    G    
W    W    W    M    M    M    M    M    M    M    M    G    G    G    G    G    G    G    G    G    G    G    G    G    G    G    G    W    W    W    W    G    G    G    G    G    G    G    G    G    G    G    G    G    M    M    M    M    M    G    G    G    G    G    G    G    G    G    G    G    G    W    W    W    G    G    G    M    G    G    
W    W    W    W    G    G    G    G    G    G    G    G    G    G    G    G    G    G    G    G    G    G    G    G    G    G    G    G    W    W    G    G    G    G    G    G    G    G    G    G    G    G    G    M    M    M    M    M    G    G    G    G    G    G    G    G    G    G    G    G    G    G    G    G    G    G    M    M    G    G    
W    W    W    W    W    G    G    G    G    G    G    G    G    W    W    W    G    G    G    G    G    G    G    G    G    G    G    G    G    G    G    G    G    G    G    G    G    G    G    G    G    G    G    M    M    M    M    M    G    G    G    G    W    W    W    G    G    G    G    G    G    G    G    G    G    M    M    M    M    G    
W    G    G    W    W    W    G    G    G    G    G    G    G    G    G C  W    W    W    G    G    G    G    G    G    G    G    G    G    G    G    G    G    G    G    G    G    G    G    G    G    G    G    G    G    M    M    M    G    G    G    G    W    W    W    W    W    W    G    G    G    G    G    G    G    M    M    M    M    G    G    
G    G    G    G    W    W    W    G    G    G    G    G    G    G    W    W    W    W    W    W    G    G    G    G    G    G    G    G    G    G    G    G    G    G    G    G    W    W    G    G    G    G    G    G    M    G    G    G    G    G    G    G    W    W    W    G+   G    G    G    G    G    G    G    M    M    M    M    G    G    G    
W    G    G    G    G    W    W    W    G    G    G    G    G    G    G    W    W    W    G    G    G    G    G    G    G    G    G    G    G    G    G    G    G    G    G    G    W    W    W    G    G    G    G    G    M    M    G    G    G    G    G    G    G S  W    W    W    G    G    G    G    G    G    M    M    M    M    G    G    G    G    
W    W    G    G    G    W    W    W    G    G    G    G    G    G    W    W    W    G    G    G    G    G    G    G    G    G*   G    G    G    G    G    G    G    G    G    G    G    W    G    G    G    G    G    M    M    G    G    G    G    G    G    W    W    W    G    G    G    G    G    G    G    M    M    M    M    M    M    G    G    G    
G    G    G    G S  G    G    W    W    G    G    G    G    G    G    G    G    G    G    G    G    G    G    G    G    G    G    G    G    G    G    G    G    G    G    G    G    G    G    G    G    G    G    G    M    M    M    M    G    G    G    G    G    G    G    G    G    G    G    G    G    M    M    M    M    G    G    M    G    G    G    
W    G    G    G C  G    G    W    W    G*   G    G    G    G    G    G    G    G    G    G    G    G    G    G    G    G    G    G    G    G    G    G    G    G    G    G    G    G    G    G    G    G    G    G    M    M    G    G    G    G    G    G    G    G    G    G    G    G    G    G    M    M    M    M    G    G    G    G    G    G    G    
W    W    W    G    G    G    W    W    W    G    G    G    G    G    G    G    G    G    G    G B  G    G    G    G    G    G    G    G    G    G    G    G    G    G    G    G    G    G    G    G    G    G    G    M    M    G    G    G    G    G    G    G    G    G    G    G    G    G    M    M    M    M    G S  G    G    G    G    G    G    G    
W    W    W    G    G    W    W    W    G    G    G    G    G    G    G    G    G    G    G    G    G    G    G    G    G    G    G    G    G    G    G    G    G    G    G    G    G    G    G    G    G    G    G    G B  M    M    G    G    G    G    G    G    G    G    G    G    G    G    M    M    M    M    M    M    M    M    M    M    M    M    
G    W    W    W    G    W    W    W    G    G    G    G    G    G    G    G    G    G    G    G    G    G    G    G    G    G    G    G    G    G    G    G    G    G    G    G    G    G    G    G    G    G    G    M    M    M    M    G    G    G    G    G    G    G    G    G    G    G    M    M    M    M    M    M    M    M    M    M    M    M    
G    G    G    G    G    W    W    W    W    G    G    G    G    G    G    G    G    G    G    G    G    G    G    G    G    G    G    G    G    G    G    G    G    G    G    G    G    G    G    G    G    G    M    M    M    M    M    M    G    G    G    G    G    G    G    G    G    G    M    M    M    M    M    M    M    M    M    M    M    M    