MMMMMMMMMMMMMMMMMMMMMMMMM
MGMMGGGGGGGGGGGGGGGGGGGGM
MGMMGGGGGGGGGGGGGGGMGGGGM
MGGGGGWWWGGGGGGGGGGGGGGGM
MGGGGGWWWWGGGGMGGGGGGMGGM
MGGGGGGWWWGGGMMGGGGGGGGGM
MGGGGGGGGGGGGGGGGGGGGGGGM
MGGGGGGGGGGGGGGGGGGGGGGGM
MGGGGGGGGGGGGGGGGWGGGGGGM
MGGGGGGGGGGGGGGGGGGGGGGGM
MGGGGMGGGGGWWWGGGGGGGGGGM
MGGGMMGGGGGWWWGGGGGMGGGGM
MGGGMGGGGGGGGGGGGGGMGGGGM
MGGGGGGGGGGGGGGGGGGGGGGGM
MGGGGGGGGGMGGGGGGGGGGGGGM
MWWWGGGGGGGGGGGGGGGGGGGGM
MGGGGGGGGGGGGGGGWWGGGGGGM
MGGGGGGGMGGGGGGGGGGGGGGGM
MGGGGGGGGGGGGGGGGGGGGGGGM
MGGMMGGGGGGGGGWWGGGGGGGGM
MGGGGGGGGGGGGGGGGGGGGGGGM
MGGGGGGGGGGGGGGGGGGGGGGGM
MGGGGGGGGGGGGGGGGGGGGGGGM
MGGGGGGGGGGGGGGGGGGGGGGGM
MMMMMMMMMMMMMMMMMMMMMMMMM