M    M    M    M    M    M    M    M    M    M    M    M    M    M    M    M    M    M    M    M    M    M    M    M    M    
M    G    M    M    G    G    G    G    G    G    G    G    G    G    G    G    G    G    G    G    G    G    G    G    M    
M    G    M    M    G    G    G    G    G    G    G    G    G    G    G    G    G    G    G    M    G    G    G    G    M    
M    G    G    G    G    G    W    W    W    G    G    G    G    G    G    G    G    G    G    G    G    G    G    G    M    
M    G B  G B  G    G    G    W    W    W    W    G    G    G    G    M    G    G    G    G    G    G    M    G    G    M    
M    G    G*   G    G    G    G    W    W    W    G*   G    G    M    M    G    G    G    G    G    G    G    G    G    M    
M    G    G    G    G    G    G    G    G    G    G    G    G    G    G    G    G    G    G    G    G    G    G    G    M    
M    G    G    G    G    G    G    G    G    G    G    G    G    G    G    G    G    G    G    G    G    G    G    G    M    
M    G    G    G    G    G    G    G    G    G    G B  G    G    G    G    G    G    W    G    G    G    G    G    G    M    
M    G    G    G    G    G    G    G    G    G    G B  G    G    G    G    G    G    G    G    G    G    G    G    G    M    
M    G    G    G    G    M    G    G    G    G B  G B  W    W    G    G    G*   G    G    G    G    G    G    G    G    M    
M    G    G    G    M    M    G    G    G    G    G    W    W    W    G    G    G    G    G    M    G    G    G    G    M    
M    G    G    G    M    G    G    G    G    G    G    G    G    G    G    G    G    G    G    M    G    G    G    G    M    
M    G    G    G    G    G    G    G    G    G    G    G    G    G    G    G    G    G    G    G    G    G    G    G    M    
M    G    G    G    G    G    G    G    G    G    M    G    G    G    G    G    G    G    G    G    G    G    G    G    M    
M    W    W    W    G    G    G    G    G    G    G    G    G    G    G    G    G    G    G    G    G    G    G    G    M    
M    G    G    G    G    G    G    G    G    G    G    G    G    G    G    G    W    W    G    G    G    G    G    G    M    
M    G    G    G    G+   G    G    G    M    G    G    G    G    G    G    G    G    G    G    G    G    G    G    G    M    
M    G    G    G    G    G    G    G    G    G    G    G    G    G    G    G    G    G    G    G    G    G    G    G    M    
M    G    G    M    M    G    G    G    G    G    G    G    G    G    W    W    G    G    G    G    G    G    G    G    M    
M    G    G    G    G    G    G    G    G    G    G    G    G    G    G    G    G    G    G    G    G    G    G    G    M    
M    G    G    G    G    G    G    G    G    G    G    G    G    G    G    G    G    G    G    G    G    G    G    G    M    
M    G    G    G    G    G    G    G    G    G    G    G    G    G    G    G    G    G    G    G    G    G    G    G    M    
M    G    G+   G    G    G    G    G    G    G    G    G    G    G    G    G    G    G    G    G    G    G    G    G    M    
M    M    M    M    M    M    M    M    M    M    M    M    M    M    M    M    M    M    M    M    M    M    M    M    M    