G    G    G    G    G    G    G    G    G    G    G    G    G    G    G    G    G    G    G    G    G    G    G    
G S  M    M    G    G    G    G    G    G    G    G    G    G    G    G    G    G    G    G    G    G    G    G    
GX x M    M    G    G    G    G    G    G    G    G    G    G    G    G    G    G    G    M    G    G    G    G    
G    G L  G    G    G    W    W    W    G    G    G    G    G    G    G    G    G    G    G    G    G    G    G    
G B  G B  G    G    G    W    W    W    W    G    G    G    G    M    G    G    G    G    G    G    M    G    G    
G    G S  G    G    G    G    W    W    W    G*   G    G    M    M    G    G    G    G    G    G    G    G    G    
G    G    G    G    G    G    G    G    G    G    G    G    G    G    G    G    G    G    G    G    G    G    G    
G    G    G    G    G    G    G    G    G    G    G    G    G    G    G    G    G    G    G    G    G    G    G    
G    G+ H G    G    G    G    G    G    G    G B  G    G    G    G    G    G    W    G    G    G    G    G    G    
G    G    G    G    G    G    G    G    G    G B  G    G    G    G    G    G    G    G    G    G    G    G    G    
G    G    G    G    M    G    G    G    G B  G B  W    W    G    G    G*   G    G    G    G    G    G    G    G    
G    G    G    M    M    G    G    G    G    G    W    W    W    G    G    G    G    G    M    G    G    G    G    
G    G    G    M    G    G    G    G    G    G    G    G    G    G    G    G    G    G    M    G    G    G    G    
G    G    G    G    G    G    G    G    G    G    G    G    G    G    G    G    G    G    G    G    G    G    G    
G    G    G    G    G    G    G    G    G    M    G    G    G    G    G    G    G    G    G    G    G    G    G    
W    W    W    G    G    G    G    G    G    G    G    G    G    G    G    G    G    G    G    G    G    G    G    
G    G    G    G    G    G    G    G    G    G    G    G    G    G    G    W    W    G    G    G    G    G    G    
G C  G    G    G+   G    G    G    M    G    G    G    G    G    G    G    G    G    G    G    G    G    G    G    
G    G    G    G    G    G    G    G    G    G    G    G    G    G    G    G    G    G    G    G    G    G    G    
G    G    M    M    G    G    G    G    G    G    G    G    G    W    W    G    G    G    G    G    G    G    G    
G    G    G    G    G    G    G    G    G    G    G    G    G    G    G    G    G    G    G    G    G    G    G    
G    G    G    G    G    G    G    G    G    G    G    G    G    G    G    G    G    G    G    G    G    G    G    
G    G    G    G    G    G    G    G    G    G    G    G    G    G    G    G    G    G    G    G    G    G    G    
G    G+   G    G    G    G    G    G    G    G    G    G    G    G    G    G    G    G    G    G    G    G    G    
G    G    G    G    G    G    G    G    G    G    G    G    G    G    G    G    G    G    G    G    G    G    G    
G    G    G    G    M    G    G    G    G B  G B  W    W    G    G    G*   G    G    G    G    G    G    G    G    
G    G    G    G    G    G    G    G    G    G    G    G    G    G    G    G    G    G    G    G    G    G    G    